anticodon	codon	aa1	aa2
GGC	GCC	A	Ala
CGC	GCG	A	Ala
AGC	GCU	A	Ala
UGC	GCA	A	Ala
UCU	AGA	R	Arg
CCG	CGG	R	Arg
CCU	AGG	R	Arg
UCG	CGA	R	Arg
GCG	CGC	R	Arg
ACG	CGU	R	Arg
GUU	AAC	N	Asn
AUU	AAU	N	Asn
GUC	GAC	D	Asp
AUC	GAU	D	Asp
GCA	UGC	C	Cys
ACA	UGU	C	Cys
UUG	CAA	Q	Gln
CUG	CAG	Q	Gln
CUC	GAG	E	Glu
UUC	GAA	E	Glu
GCC	GGC	G	Gly
ACC	GGU	G	Gly
UCC	GGA	G	Gly
CCC	GGG	G	Gly
GUG	CAC	H	His
AUG	CAU	H	His
UAU	AUA	I	Ile
GAU	AUC	I	Ile
AAU	AUU	I	Ile
CAG	CUG	L	Leu
UAG	CUA	L	Leu
UAA	UUA	L	Leu
AAG	CUU	L	Leu
CAA	UUG	L	Leu
GAG	CUC	L	Leu
UUU	AAA	K	Lys
CUU	AAG	K	Lys
CAU	AUG	M	Met
GAA	UUC	F	Phe
AAA	UUU	F	Phe
CGG	CCG	P	Pro
GGG	CCC	P	Pro
AGG	CCU	P	Pro
UGG	CCA	P	Pro
GCU	AGC	S	Ser
CGA	UCG	S	Ser
AGA	UCU	S	Ser
UGA	UCA	S	Ser
GGA	UCC	S	Ser
ACU	AGU	S	Ser
CUA	UAG	*	Stop
UUA	UAA	*	Stop
UCA	UGA	*	Stop
UGU	ACA	T	Thr
GGU	ACC	T	Thr
CGU	ACG	T	Thr
AGU	ACU	T	Thr
CCA	UGG	W	Trp
AUA	UAU	Y	Tyr
GUA	UAC	Y	Tyr
UAC	GUA	V	Val
CAC	GUG	V	Val
AAC	GUU	V	Val
GAC	GUC	V	Val
